WWWWWWWWWWWWWWWWWWWWWW
WWWWWWWWWWWWWWWWWWWWWW
WWWWWWWWWWWWWLLLLLLWWW
WWWWWWWWWWWWWLWWWWWWWW
WWLLLLLLLLLLLLWWWWWWWW
WWWWLWWWWWWWWLWWWWWWWW
WWWWLWWWWWWWWLLLLLWWWW
WWWWLWWWWWWWWWWWWLWWWW
WWWWLWWWWWWWWWWWWLWWWW
WWWWLLLLLLWWLLLLLLWWWW
WWWWWWWWWLWWLWWWWWWWWW
WWWWWWWWWLWWLWWWWWWWWW
WWWWWWWWWLWWLWWWWWWWWW
WWWWWWWWWLWWLWWWWWWWWW
WWWWWWWWWLWWLWWWWWWWWW
WLLLLLLLLLWWLLLLLLLIEW
WWWWWWWWWWWWWWWWWWWWWW
WWWWWWWWWWWWWWWWWWWWWW
WWWWWWWWWWWWWWWWWWWWWW
WWWWWWWWWWWWWWWWWWWWWW
