WWWWWWWWWWWWWWWWWWWWWWWW
WWWILLLLLRLLLLLLLLILLLIW
WWWWWWWWWLWWWWWWWWLWWWLW
WWWWWWWWWLWWWWWWWWLWWWLW
WWWWWWWWWLWWWWWWWWLWWWLW
WWWWWWWWWLWWWWWWWWLWWWLW
WWWWILLLLIWWWWWWWWLWWWLW
WWWWLWWWWLWWWWWWWWLWWWLW
WWWWLWWWWLWWWWWWWWLWWWLW
WWWWLWWWWLWWWWWWWWLWWWLW
WWWWILLLLILLLLLLLLIWWWIW
WWWWLWWWWWWWWWWWWWWWWWLW
WWWWLWWWWWWWWWWWWWWWWWLW
WWWWLWWWWWWWWWWWWWWWWWLW
WILLIWWWWWWWWWWWWWWWWWLW
WWWWLWWWWWWWWWWWWWWWWWLW
WWWWLWWWWWWWWWWWWWWWWWLW
WWWWILLLLLLLLLLLLILLLLIW
WWWWLWWWWWWWWWWWWWWWWWWW
WWWWLWWWWWWWWWWWWWWWWWWW
WWWWLWWWWWWWWWWWWWWWWWWW
WWWWLWWWWWWWWWWWWWWWWWWW
WWWWIWWWWWWWWWWWWWWWWWWW
WWWWLWWWWWWWWWWWWWWWWWWW
WWWWLWWWWWWWWWWWWWWWWWWW
WWWWILLLILLLILLLIEWWWWWW
WWWWWWWWWWWWWWWWWWWWWWWW