WWWWWWWWWWWWWWWWWWWWWW
WWWWWWWWWWWWWWWWWWWWWW
WWWWWWWWWWWWWWWWWWWWWW
WWWWWWWWWWWWWWWWWWWWWW
WWWWWWWWWWWWWWWWWWWWWW
WWWWWWWWWWWWWLLLLLWWWW
WWWWWWWWWWWWWLWWWLWWWW
WWWWWWWWWWWWWLWWWLWWWW
WRLLLLLWWWWWWLWWWLLIEW
WWWWWWLWWWWWWLWWWWWWWW
WWWWWWLWWWWWWLWWWWWWWW
WWWWWWLWWWWWWLWWWWWWWW
WWWWWWLWWWWWWLWWWWWWWW
WWWWWWLLLLLLLLWWWWWWWW
WWWWWWWWWWWWWWWWWWWWWW
WWWWWWWWWWWWWWWWWWWWWW
WWWWWWWWWWWWWWWWWWWWWW
WWWWWWWWWWWWWWWWWWWWWW
WWWWWWWWWWWWWWWWWWWWWW
WWWWWWWWWWWWWWWWWWWWWW