WWWWWWWWWWWWWWWWWWWWWW
WWWWWWWWWWWWWBBBBBBWWW
WWWWWWWWWWWWWILLLLIWWW
WWBBBBBBBBBBBLWWWWWWWW
WWILILLLLLLLLIWWWWWWWW
WWWWLWWWWWWWWLBBBBWWWW
WWWWLWWWWWWWWILLLIWWWW
WWWWLWWWWWWWWWWWWLWWWW
WWWWLBBBBBWWBBBBBLWWWW
WWWWILLLLIWWILLLLIWWWW
WWWWWWWWWLWWLWWWWWWWWW
WWWWWWWWWLWWLWWWWWWWWW
WWWWWWWWWLWWLWWWWWWWWW
WWWWWWWWWLWWLWWWWWWWWW
WBBBBBBBBLWWLBBBBBBBBW
WEILLLLLLIWWILLLLLLLRW
WWWWWWWWWWWWWWWWWWWWWW
WWWWWWWWWWWWWWWWWWWWWW
WWWWWWWWWWWWWWWWWWWWWW
WWWWWWWWWWWWWWWWWWWWWW
