WWWWWWWWWWWWWWWWWWWWWW
WWWWWWWWWWWWWWWWWWWWWW
WWWWWWWWWWWWWWWWWWWWWW
WWWWWWWWWWWWWWWWWWWWWW
WWWWWWWWWWWWWBBBBBWWWW
WWWWWWWWWWWWWILLLIWWWW
WWWWWWWWWWWWWLWWWLWWWW
WBBBBBBWWWWWWLWWWLBBBW
WRLLLLIWWWWWWLWWWILIEW
WWWWWWLWWWWWWLWWWWWWWW
WWWWWWLWWWWWWLWWWWWWWW
WWWWWWLWWWWWWLWWWWWWWW
WWWWWWLBBBBBBLWWWWWWWW
WWWWWWILLLLLLIWWWWWWWW
WWWWWWWWWWWWWWWWWWWWWW
WWWWWWWWWWWWWWWWWWWWWW
WWWWWWWWWWWWWWWWWWWWWW
WWWWWWWWWWWWWWWWWWWWWW
WWWWWWWWWWWWWWWWWWWWWW
WWWWWWWWWWWWWWWWWWWWWW