WWWWWWWWWWWWWLWWWWWWWWWW
WWWWWWWWWWWWWLWWWWWWWWWW
WWWWWLWWWLLLLLLWWWWWWWWW
WWWWWLWWWLWWWWLWWWWWWWWW
WWWWWLWWWLWWWWLWWWWWWWWW
WWWWWLLLLLLLLWLLLLWWWWWW
WWWWWWWWWWWWLWWWWLWWWWWW
WWWWWWWWWWWWLWWWWLWWWWWW
WWWWWWWWWWWWLWWWWLWWWWWW
WWWWWWWWWWWWLWWWWLWWWWWW
WWWWWWWWWLLLLLLLLLWWWWWW
WWWWWWWWWLWWWWWWWLWWWWWW
WWWWWWWWWLWWWWWWWLWWWWWW
WWLLLLLLLLLLLWWWWLWWWWWW
WWLWWWLWWWWWWWWWWLWWWWWW
WWLWWWLWWWWWWWWWWLWWWWWW
WWWWWWLLLLWWWWWWWLWWWWWW
WWWWWWLWWLWWWWWWWLWWWWWW
WWWWWWLWWLWWWWWWWLWWWWWW
WWWWWWLWWLLLLWWWWLWWWWWW
WWWWWWWWWLWWLWWWWLWWWWWW
WWWWWWWWWLWWLWWWWLWWWWWW
WWWWWWLLLLLLLLLLLLWWWWWW
WWWWWWLWWWWWWWWWWWWWWWWW
WWWWWWLWWWWWWWWWWWWWWWWW