WBWWWWWWWWWBWWBWWW
WLWWWWBWBBWLWWLWBW
WWWWWBLWLLWBBBWBLW
WWWBBRWWWWBLLLWLWW
WWWLLWWBWWLWWWWWWW
WWWWWWWLWWWWWWWWWW
WWWWWWWWWWWWWWWWWW