WWWBBBBBBBBBBBBBBBBBBBBW
WWWILLLLLRLLLLLLLLILLLIW
WWWWWWWWWLWWWWWWWWLWWWLW
WWWWWWWWWLWWWWWWWWLWWWLW
WWWWWWWWWLWWWWWWWWLWWWLW
WWWWBBBBBLWWWWWWWWLWWWLW
WWWWILLLLIWWWWWWWWLWWWLW
WWWWLWWWWLWWWWWWWWLWWWLW
WWWWLWWWWLWWWWWWWWLWWWLW
WWWWLBBBBLBBBBBBBBLWWWLW
WWWWILLLLILLLLLLLLIWWWIW
WWWWLWWWWWWWWWWWWWWWWWLW
WWWWLWWWWWWWWWWWWWWWWWLW
WBBBLWWWWWWWWWWWWWWWWWLW
WILLIWWWWWWWWWWWWWWWWWLW
WWWWLWWWWWWWWWWWWWWWWWLW
WWWWLBBBBBBBBBBBBBBBBBLW
WWWWILLLLLLLLLLLLILLLLIW
WWWWLWWWWWWWWWWWWWWWWWWW
WWWWLWWWWWWWWWWWWWWWWWWW
WWWWLWWWWWWWWWWWWWWWWWWW
WWWWLWWWWWWWWWWWWWWWWWWW
WWWWIWWWWWWWWWWWWWWWWWWW
WWWWLWWWWWWWWWWWWWWWWWWW
WWWWLBBBBBBBBBBBBBWWWWWW
WWWWILLLILLLILLLIEWWWWWW
WWWWWWWWWWWWWWWWWWWWWWWW