WWWWWWWWWWWWWWWWWWWW
WWWWWWWWWWWWWWWWWWWW
WWWWWWWWWWWWWWWWWWWW
WWWWWWWWWWWWWWWWWWWW
WWWWWWWWWWWWWWWWWWWW
WWWWWWWWWWWWLLLLLWWW
WWWWWWWWWWWWLWWWLWWW
WWWWWWWWWWWWLWWWLWWW
LLLLLLWWWWWWLWWWLLLL
WWWWWLWWWWWWLWWWWWWW
WWWWWLWWWWWWLWWWWWWW
WWWWWLWWWWWWLWWWWWWW
WWWWWLWWWWWWLWWWWWWW
WWWWWLLLLLLLLWWWWWWW
WWWWWWWWWWWWWWWWWWWW
WWWWWWWWWWWWWWWWWWWW
WWWWWWWWWWWWWWWWWWWW
WWWWWWWWWWWWWWWWWWWW
WWWWWWWWWWWWWWWWWWWW
WWWWWWWWWWWWWWWWWWWW