WWWWWWWWWWWWWWWWWWWW
WWWWWWWWWWWWWWWWWWWW
WWWWWWWWWWWWLLLLLLWW
WWWWWWWWWWWWLWWWWWWW
WLLLLLLLLLLLLWWWWWWW
WWWLWWWWWWWWLWWWWWWW
WWWLWWWWWWWWLLLLLWWW
WWWLWWWWWWWWWWWWLWWW
WWWLWWWWWWWWWWWWLWWW
WWWLLLLLLWWLLLLLLWWW
WWWWWWWWLWWLWWWWWWWW
WWWWWWWWLWWLWWWWWWWW
WWWWWWWWLWWLWWWWWWWW
WWWWWWWWLWWLWWWWWWWW
WWWWWWWWLWWLWWWWWWWW
LLLLLLLLLWWLLLLLLLLL
WWWWWWWWWWWWWWWWWWWW
WWWWWWWWWWWWWWWWWWWW
WWWWWWWWWWWWWWWWWWWW
WWWWWWWWWWWWWWWWWWWW
