WWWWWWWWWWWWWWWWWWWWWW
WWWWWWWWWWWWWWWWWWWWWW
WWWWWWWWWWWWWWWWWWWWWW
WWWWWWWWWWWWWWWWWWWWWW
WWWWWWWWWWWWWWWWWWWWWW
WWWWWWWWWWWWWILLLIWWWW
WWWWWWWWWWWWWLWWWLWWWW
WWWWWWWWWWWWWLWWWLWWWW
WRLLLLIWWWWWWLWWWILIEW
WWWWWWLWWWWWWLWWWWWWWW
WWWWWWLWWWWWWLWWWWWWWW
WWWWWWLWWWWWWLWWWWWWWW
WWWWWWLWWWWWWLWWWWWWWW
WWWWWWILLLLLLIWWWWWWWW
WWWWWWWWWWWWWWWWWWWWWW
WWWWWWWWWWWWWWWWWWWWWW
WWWWWWWWWWWWWWWWWWWWWW
WWWWWWWWWWWWWWWWWWWWWW
WWWWWWWWWWWWWWWWWWWWWW
WWWWWWWWWWWWWWWWWWWWWW