WWWWWWWWWWWWWWWWWWWWWW
WWWWWWWWWWWWWWWWWWWWWW
WWWWWWWWWWWWWILLLLIWWW
WWWWWWWWWWWWWLWWWWWWWW
WWILILLLLLLLLIWWWWWWWW
WWWWLWWWWWWWWLWWWWWWWW
WWWWLWWWWWWWWILLLIWWWW
WWWWLWWWWWWWWWWWWLWWWW
WWWWLWWWWWWWWWWWWLWWWW
WWWWILLLLIWWILLLLIWWWW
WWWWWWWWWLWWLWWWWWWWWW
WWWWWWWWWLWWLWWWWWWWWW
WWWWWWWWWLWWLWWWWWWWWW
WWWWWWWWWLWWLWWWWWWWWW
WWWWWWWWWLWWLWWWWWWWWW
WEILLLLLLIWWILLLLLLLRW
WWWWWWWWWWWWWWWWWWWWWW
WWWWWWWWWWWWWWWWWWWWWW
WWWWWWWWWWWWWWWWWWWWWW
WWWWWWWWWWWWWWWWWWWWWW
