WWWWWWWWWWWWWWWWWWWWWWWW
WWWWWWWWWWWWWRWWWWWWWWWW
WWWWWWWWWWWWWLWWWWWWWWWW
WWWWWLWWWLLLLILWWWWWWWWW
WWWWWLWWWLWWWWLWWWWWWWWW
WWWWWLWWWLWWWWLWWWWWWWWW
WWWWWLLLLILLLWLLLLWWWWWW
WWWWWWWWWWWWLWWWWLWWWWWW
WWWWWWWWWWWWLWWWWLWWWWWW
WWWWWWWWWWWWLWWWWLWWWWWW
WWWWWWWWWWWWLWWWWLWWWWWW
WWWWWWWWWLLLILLLLIWWWWWW
WWWWWWWWWLWWWWWWWLWWWWWW
WWWWWWWWWLWWWWWWWLWWWWWW
WWLLLLILLILLLWWWWLWWWWWW
WWLWWWLWWWWWWWWWWLWWWWWW
WWLWWWLWWWWWWWWWWLWWWWWW
WWWWWWILLLWWWWWWWLWWWWWW
WWWWWWLWWLWWWWWWWLWWWWWW
WWWWWWLWWLWWWWWWWLWWWWWW
WWWWWWLWWILLLWWWWLWWWWWW
WWWWWWWWWLWWLWWWWLWWWWWW
WWWWWWWWWLWWLWWWWLWWWWWW
WWWWWWLLLILLILLLLLWWWWWW
WWWWWWIWWWWWWWWWWWWWWWWW
WWWWWWEWWWWWWWWWWWWWWWWW
WWWWWWWWWWWWWWWWWWWWWWWW